&lt;	<	小于号
&gt;	>	大于号
&quot;	"	引号

&apos;	'	撇号
&nbsp;	 	无中断空格
&iexcl;	¡	竖翻叹号
&cent;	¢	分币标记
&pound;	£	英镑标记
&curren;	¤	货币标记
&yen;	¥	日元标记
&brvbar;	¦	间断条
&sect;	§	节标记
&uml;	¨	分音符
&copy;	©	版权所有标记
&ordf;	ª	阴性顺序指示符
&laquo;	«	左指双尖引号
&not;	¬	非标记
&shy;	软连字符
&reg;	®	注册标记
&macr;	¯	长音符
&deg;	°	度标记
&plusmn;	±	正负号
&sup2;	²	上标二
&sup3;	³	上标三
&acute;	´	锐音符
&micro;	µ	微单位标记
&para;	¶	段落标记
&middot;	·	中间点
&cedil;	¸	软音符
&sup1;	¹	上标一
&ordm;	º	阳性顺序指示符
&raquo;	»	右指双尖引号
&frac14;	¼	普通分数四分之一
&frac12;	½	普通分数二分之一
&frac34;	¾	普通分数四分之三
&iquest;	¿	竖翻问号
&Agrave;	À	带抑音符的拉丁文大写字母 A
&Aacute;	Á	带锐音符的拉丁文大写字母 A
&Acirc;	Â	带扬抑符的拉丁文大写字母 A
&Atilde;	Ã	带颚化符的拉丁文大写字母 A
&Auml;	Ä	带分音符的拉丁文大写字母 A
&Aring;	Å	带上圆圈的拉丁文大写字母 A
&AElig;	Æ	拉丁文大写字母 Ae
&Ccedil;	Ç	带软音符的拉丁文大写字母 C
&Egrave;	È	带抑音符的拉丁文大写字母 E
&Eacute;	É	带锐音符的拉丁文大写字母 E
&Ecirc;	Ê	带扬抑符的拉丁文大写字母 E
&Euml;	Ë	带分音符的拉丁文大写字母 E
&Igrave;	Ì	带抑音符的拉丁文大写字母 I
&Iacute;	Í	带锐音符的拉丁文大写字母 I
&Icirc;	Î	带扬抑符的拉丁文大写字母 I
&Iuml;	Ï	带分音符的拉丁文大写字母 I
&ETH;	Ð	拉丁文大写字母 Eth
&Ntilde;	Ñ	带颚化符的拉丁文大写字母 N
&Ograve;	Ò	带抑音符的拉丁文大写字母 O
&Oacute;	Ó	带锐音符的拉丁文大写字母 O
&Ocirc;	Ô	带扬抑符的拉丁文大写字母 O
&Otilde;	Õ	带颚化符的拉丁文大写字母 O
&Ouml;	Ö	带分音符的拉丁文大写字母 O
&times;	×	乘号
&Oslash;	Ø	带粗线的拉丁文大写字母 O
&Ugrave;	Ù	带抑音符的拉丁文大写字母 U
&Uacute;	Ú	带锐音符的拉丁文大写字母 U
&Ucirc;	Û	带扬抑符的拉丁文大写字母 U
&Uuml;	Ü	带分音符的拉丁文大写字母 U
&Yacute;	Ý	带锐音符的拉丁文大写字母 Y
&THORN;	Þ	拉丁文大写字母 Thorn
&szlig;	ß	拉丁文小写字母清音 S
&agrave;	à	带抑音符的拉丁文小写字母 A
&aacute;	á	带锐音符的拉丁文小写字母 A
&acirc;	â	带扬抑符的拉丁文小写字母 A
&atilde;	ã	带颚化符的拉丁文小写字母 A
&auml;	ä	带分音符的拉丁文小写字母 A
&aring;	å	带上圆圈的拉丁文小写字母 A
&aelig;	æ	拉丁文小写字母 Ae
&ccedil;	ç	带软音符的拉丁文小写字母 C
&egrave;	è	带抑音符的拉丁文小写字母 E
&eacute;	é	带锐音符的拉丁文小写字母 E
&ecirc;	ê	带扬抑符的拉丁文小写字母 E
&euml;	ë	带分音符的拉丁文小写字母 E
&igrave;	ì	带抑音符的拉丁文小写字母 I
&iacute;	í	带锐音符的拉丁文小写字母 I
&icirc;	î	带扬抑符的拉丁文小写字母 I
&iuml;	ï	带分音符的拉丁文小写字母 I
&eth;	ð	拉丁文小写字母 Eth
&ntilde;	ñ	带颚化符的拉丁文小写字母 N
&ograve;	ò	带抑音符的拉丁文小写字母 O
&oacute;	ó	带锐音符的拉丁文小写字母 O
&ocirc;	ô	带扬抑符的拉丁文小写字母 O
&otilde;	õ	带颚化符的拉丁文小写字母 O
&ouml;	ö	带分音符的拉丁文小写字母 O
&divide;	÷	除号
&oslash;	ø	带粗线的拉丁文小写字母 O
&ugrave;	ù	带抑音符的拉丁文小写字母 U
&uacute;	ú	带锐音符的拉丁文小写字母 U
&ucirc;	û	带扬抑符的拉丁文小写字母 U
&uuml;	ü	带分音符的拉丁文小写字母 U
&yacute;	ý	带锐音符的拉丁文小写字母 Y
&thorn;	þ	拉丁文小写字母 Thorn
&yuml;	ÿ	带分音符的拉丁文小写字母 Y
&OElig;	Œ	拉丁文大写连字 Oe
&oelig;	œ	拉丁文小型连字 Oe
&Scaron;	Š	带抑扬符的拉丁文大写字母 S
&scaron;	š	带抑扬符的拉丁文小写字母 S
&Yuml;	Ÿ	带分音符的拉丁文大写字母 Y
&fnof;	ƒ	带钩的拉丁文小写字母 F
&circ;	ˆ	修饰字母扬抑符
&tilde;	˜	小型颚化符
&Alpha;	Α	希腊文大写字母 Alpha
&Beta;	Β	希腊文大写字母 Beta
&Gamma;	Γ	希腊文大写字母 Gamma
&Delta;	Δ	希腊文大写字母 Delta
&Epsilon;	Ε	希腊文大写字母 Epsilon
&Zeta;	Ζ	希腊文大写字母 Zeta
&Eta;	Η	希腊文大写字母 Eta
&Theta;	Θ	希腊文大写字母 Theta
&Iota;	Ι	希腊文大写字母 Iota
&Kappa;	Κ	希腊文大写字母 Kappa
&Lambda;	Λ	希腊文大写字母 Lamda
&Mu;	Μ	希腊文大写字母 Mu
&Nu;	Ν	希腊文大写字母 Nu
&Xi;	Ξ	希腊文大写字母 Xi
&Omicron;	Ο	希腊文大写字母 Omicron
&Pi;	Π	希腊文大写字母 Pi
&Rho;	Ρ	希腊文大写字母 Rho
&Sigma;	Σ	希腊文大写字母 Sigma
&Tau;	Τ	希腊文大写字母 Tau
&Upsilon;	Υ	希腊文大写字母 Upsilon
&Phi;	Φ	希腊文大写字母 Phi
&Chi;	Χ	希腊文大写字母 Chi
&Psi;	Ψ	希腊文大写字母 Psi
&Omega;	Ω	希腊文大写字母 Omega
&alpha;	α	希腊文小写字母 Alpha
&beta;	β	希腊文小写字母 Beta
&gamma;	γ	希腊文小写字母 Gamma
&delta;	δ	希腊文小写字母 Delta
&epsilon;	ε	希腊文小写字母 Epsilon
&zeta;	ζ	希腊文小写字母 Zeta
&eta;	η	希腊文小写字母 Eta
&theta;	θ	希腊文小写字母 Theta
&iota;	ι	希腊文小写字母 Iota
&kappa;	κ	希腊文小写字母 Kappa
&lambda;	λ	希腊文小写字母 Lamda
&mu;	μ	希腊文小写字母 Mu
&nu;	ν	希腊文小写字母 Nu
&xi;	ξ	希腊文小写字母 Xi
&omicron;	ο	希腊文小写字母 Omicron
&pi;	π	希腊文小写字母 Pi
&rho;	ρ	希腊文小写字母 Rho
&sigmaf;	ς	希腊文小写字母词尾 Sigma
&sigma;	σ	希腊文小写字母 Sigma
&tau;	τ	希腊文小写字母 Tau
&upsilon;	υ	希腊文小写字母 Upsilon
&phi;	φ	希腊文小写字母 Phi
&chi;	χ	希腊文小写字母 Chi
&psi;	ψ	希腊文小写字母 Psi
&omega;	ω	希腊文小写字母 Omega
&thetasym;	ϑ	希腊文 Theta 符号
&upsih;	ϒ	带钩形符号的希腊文 Upsilon
&piv;	ϖ	希腊文 Pi 符号
&ensp;	 	En 间隔
&emsp;	 	Em 间隔
&thinsp;	 	窄间隔
&zwnj;		零宽无连接符
&zwj;		零宽连接符
&lrm;	‎	从左至右标志
&rlm;	‏	从右至左标志
&ndash;	–	En 长划
&mdash;	—	Em 长划
&lsquo;	‘	左单引号
&rsquo;	’	右单引号
&sbquo;	‚	单下 9 形引号
&ldquo;	“	左双引号
&rdquo;	”	右双引号
&bdquo;	„	双下 9 形引号
&dagger;	†	剑号
&Dagger;	‡	双剑号
&bull;	•	加重号
&hellip;	…	水平省略号
&permil;	‰	千分号
&prime;	′	上标符
&Prime;	″	双上标符
&lsaquo;	‹	单左指尖引号
&rsaquo;	›	单右指尖引号
&oline;	‾	上横线
&frasl;	⁄	分数斜线号
&euro;	€	欧元符号
&image;	ℑ	黑花体字大写 I
&weierp;	℘	手写体大写 P
&real;	ℜ	黑花体字大写 R
&trade;	™	商标标记
&alefsym;	ℵ	Alef 符号
&larr;	←	向左箭头
&uarr;	↑	向上箭头
&rarr;	→	向右箭头
&darr;	↓	向下箭头
&harr;	↔	左右箭头
&crarr;	↵	角朝左的向下箭头
&lArr;	⇐	向左双箭头
&uArr;	⇑	向上双箭头
&rArr;	⇒	向右双箭头
&dArr;	⇓	向下双箭头
&hArr;	⇔	左右双箭头
&forall;	∀	对于全部
&part;	∂	偏微分
&exist;	∃	存在
&empty;	∅	空集
&nabla;	∇	劈形算符
&isin;	∈	元素
&notin;	∉	不是元素
&ni;	∋	包含
&prod;	∏	N 元乘积
&sum;	∑	N 元求和
&minus;	−	负号
&lowast;	∗	星号运算符
&radic;	√	平方根
&prop;	∝	比例
&infin;	∞	无穷大
&ang;	∠	角
&and;	∧	逻辑与
&or;	∨	逻辑或
&cap;	∩	交集
&cup;	∪	并集
&int;	∫	积分
&there4;	∴	所以
&sim;	∼	颚化符运算符
&cong;	≅	近似等于
&asymp;	≈	约等于
&ne;	≠	不等于
&equiv;	≡	恒等于
&le;	≤	小于或等于
&ge;	≥	大于或等于
&sub;	⊂	子集
&sup;	⊃	超集
&nsub;	⊄	非子集
&sube;	⊆	子集或等于
&supe;	⊇	超集或等于
&oplus;	⊕	带圆圈正号
&otimes;	⊗	带圆圈乘号
&perp;	⊥	上丁字
&sdot;	⋅	点运算符
&lceil;	⌈	左顶棚
&rceil;	⌉	右顶棚
&lfloor;	⌊	左地板
&rfloor;	⌋	右地板
&lang;	〈	左指尖括号
&rang;	〉	右指尖括号
&loz;	◊	菱形
&spades;	♠	实心黑桃纸牌
&clubs;	♣	实心梅花纸牌
&hearts;	♥	实心红桃纸牌
&diams;	♦	实心方块纸牌

&amp;	&	与号
