abw	阿鲁巴
afg	阿富汗
ago	安哥拉
aho	荷属安的列斯
aia	安圭拉
aidj	法国阿法斯和埃萨斯
ala	奥兰
alb	阿尔巴尼亚
alg	阿尔及利亚
and	安道尔
ang	安哥拉
anhh	荷属安的列斯
ant	荷属安的列斯
are	阿联酋
arg	阿根廷
arm	亚美尼亚
aru	阿鲁巴
asa	美属萨摩亚
asean	东盟
asm	美属萨摩亚
ata	南极洲
atf	法属南部领地
atg	安提瓜和巴布达
aus	澳大利亚
aut	奥地利
aze	阿塞拜疆
bah	巴哈马
ban	孟加拉
bar	巴巴多斯
bdi	布隆迪
bel	比利时
ben	贝宁
ber	百慕大
bes	加勒比荷兰
bfa	布基纳法索
bgd	孟加拉
bgr	保加利亚
bhr	巴林
bhs	巴哈马
bhu	不丹
bih	波斯尼亚和黑塞哥维那
bir	缅甸
biz	伯利兹
blm	圣巴泰勒米
blr	白俄罗斯
blz	伯利兹
bmu	百慕大
boe	博奈尔
bol	玻利维亚
bot	博茨瓦纳
bqaq	英属南极领地
bra	巴西
brb	巴巴多斯
brn	文莱
bru	文莱
btn	不丹
bul	保加利亚
bumm	缅甸
bur	布基纳法索
bvt	布韦岛
bwa	博茨瓦纳
byaa	白俄罗斯
caf	中非
cam	柬埔寨
can	加拿大
cay	开曼群岛
cck	科科斯（基林）群岛
cgo	刚果（布）
cha	乍得
che	瑞士
chi	智利
chl	智利
chn	中国
civ	科特迪瓦
cmr	喀麦隆
cod	刚果（金）
cog	刚果（布）
cok	库克群岛
col	哥伦比亚
com	科摩罗
cpv	佛得角
crc	哥斯达黎加
cri	哥斯达黎加
cro	克罗地亚
cshh	捷克斯洛伐克
csk	捷克斯洛伐克
csxx	塞尔维亚和黑山
cta	中非
ctki	坎顿及恩德伯里群岛
cub	古巴
cuw	库拉索
cxr	圣诞岛
cym	开曼群岛
cyp	塞浦路斯
cze	捷克
ddde	东德
ddr	东德
den	丹麦
deu	德国
dji	吉布提
dma	多米尼克
dnk	丹麦
dom	多米尼加
dprk	朝鲜民主主义人民共和国
dybj	达荷美
dza	阿尔及利亚
ecu	厄瓜多尔
egy	埃及
eng	英格兰
eqg	赤道几内亚
eri	厄立特里亚
esa	萨尔瓦多
esh	阿拉伯撒哈拉民主共和国
esp	西班牙
est	爱沙尼亚
eth	埃塞俄比亚
etm	东帝汶
eu	欧盟
fij	斐济
fin	芬兰
fji	斐济
flk	福克兰群岛
fqhh	法属南方和南极洲领地
fra	法国
fro	法罗群岛
fsm	密克罗尼西亚联邦
fxfr	法国本土
gab	加蓬
gam	冈比亚
gbr	英国
gbs	几内亚比绍
gehh	吉尔伯特及埃里斯群岛
geo	格鲁吉亚
geq	赤道几内亚
ger	德国
ggy	根西
gha	加纳
gib	直布罗陀
gin	几内亚
glp	瓜德罗普
gmb	冈比亚
gnb	几内亚比绍
gnq	赤道几内亚
grc	希腊
grd	格林纳达
gre	希腊
grl	格陵兰
grn	格林纳达
gtm	危地马拉
gua	危地马拉
guf	法属圭亚那
gui	几内亚
gum	关岛
guy	圭亚那
hai	海地
hkg	香港
hmd	赫德岛和麦克唐纳群岛
hnd	洪都拉斯
hon	洪都拉斯
hrv	克罗地亚
hti	海地
hun	匈牙利
hvbf	上伏塔
idn	印尼
imn	马恩岛
ina	印尼
ind	印度
iom	马恩岛
iot	英属印度洋领地
iri	伊朗
irl	爱尔兰
irn	伊朗
irq	伊拉克
isl	冰岛
isr	以色列
isv	美属维尔京群岛
ita	意大利
ivb	英属维尔京群岛
jam	牙买加
jey	泽西
jor	约旦
jpn	日本
jtum	约翰斯顿环礁
kaz	哈萨克斯坦
ken	肯尼亚
kgz	吉尔吉斯斯坦
khm	柬埔寨
kir	基里巴斯
kna	圣基茨和尼维斯
kor	韩国
ksa	沙特阿拉伯
kuw	科威特
kwt	科威特
lao	老挝
lat	拉脱维亚
lba	利比亚
lbn	黎巴嫩
lbr	利比里亚
lby	利比亚
lca	圣卢西亚
les	莱索托
lib	黎巴嫩
lie	列支敦士登
lka	斯里兰卡
lso	莱索托
ltu	立陶宛
lux	卢森堡
lva	拉脱维亚
mac	澳门
mad	马达加斯加
maf	法属圣马丁
mar	摩洛哥
mas	马来西亚
maw	马拉维
mco	摩纳哥
mda	摩尔多瓦
mdg	马达加斯加
mdv	马尔代夫
mex	墨西哥
mgl	蒙古
mhl	马绍尔群岛
mium	中途岛
mkd	马其顿
mli	马里
mlt	马耳他
mmr	缅甸
mne	黑山
mng	蒙古
mnp	北马里亚纳群岛
mon	摩纳哥
moz	莫桑比克
mri	毛里求斯
mrt	毛里塔尼亚
msr	蒙特塞拉特
mtn	毛里塔尼亚
mtq	马提尼克
mus	毛里求斯
mwi	马拉维
mya	缅甸
mys	马来西亚
myt	马约特
nam	纳米比亚
nca	尼加拉瓜
ncl	新喀里多尼亚
ned	荷兰
nep	尼泊尔
ner	尼日尔
nfk	诺福克岛
nga	尼日利亚
ngr	尼日利亚
nhvu	新赫布里底
nic	尼加拉瓜
nig	尼日尔
nir	北爱尔兰
niu	纽埃
nkr	纳戈尔诺-卡拉巴赫
nld	荷兰
nor	挪威
npl	尼泊尔
nqaq	挪威毛德皇后地
nru	瑙鲁
nthh	沙特阿拉伯—伊拉克中立区
nzl	新西兰
oma	阿曼
omn	阿曼
pak	巴基斯坦
pan	巴拿马
par	巴拉圭
pchh	太平洋群岛托管地
pcn	皮特凯恩群岛
per	秘鲁
phi	菲律宾
phl	菲律宾
ple	巴勒斯坦
plw	帕劳
png	巴布亚新几内亚
pol	波兰
por	葡萄牙
pri	波多黎各
prk	朝鲜
prt	葡萄牙
pry	巴拉圭
pse	巴勒斯坦
pur	波多黎各
puum	美国美国其它太平洋岛屿
pyf	法属波利尼西亚
pzpa	巴拿马运河区
qat	卡塔尔
reu	留尼汪
rhzw	罗德西亚
rok	韩国
rom	罗马尼亚
rou	罗马尼亚
rsa	南非
rus	俄罗斯
rwa	卢旺达
sadr	阿拉伯撒哈拉民主共和国
sam	萨摩亚
sau	沙特阿拉伯
scg	塞尔维亚和黑山
sco	苏格兰
sct	苏格兰
sdn	苏丹
sen	塞内加尔
sey	塞舌尔
sgp	新加坡
sgs	南乔治亚和南桑威奇群岛
shn	圣赫勒拿
sin	新加坡
sjm	斯瓦尔巴群岛和扬马延岛
skin	锡金
skn	圣基茨和尼维斯
slb	所罗门群岛
sle	塞拉利昂
slo	斯洛文尼亚
slv	萨尔瓦多
smr	圣马力诺
sol	所罗门群岛
som	索马里
spm	圣皮埃尔和密克隆
srb	塞尔维亚
sri	斯里兰卡
ssd	南苏丹
stp	圣多美和普林西比
sud	苏丹
suhh	苏联
sui	瑞士
sur	苏里南
svk	斯洛伐克
svn	斯洛文尼亚
swe	瑞典
swz	斯威士兰
sxm	荷属圣马丁
syc	塞舌尔
syr	叙利亚
tan	坦桑尼亚
tca	特克斯和凯科斯群岛
tcd	乍得
tga	汤加
tgo	多哥
tha	泰国
tjk	塔吉克斯坦
tkl	托克劳
tkm	土库曼斯坦
tls	东帝汶
tog	多哥
ton	汤加
tptl	东帝汶
tri	特立尼达和多巴哥
trnc	北塞浦路斯
tto	特立尼达和多巴哥
tun	突尼斯
tur	土耳其
tuv	图瓦卢
twn	台湾台湾
tza	坦桑尼亚
uga	乌干达
uk	英国
ukr	乌克兰
umi	美国本土外小岛屿
uno	联合国
uru	乌拉圭
ury	乌拉圭
us	美国
usa	美国
ussr	苏联
uzb	乌兹别克斯坦
van	瓦努阿图
vat	梵蒂冈
vct	圣文森特和格林纳丁斯
vdvn	北越
ven	委内瑞拉
vgb	英属维尔京群岛
vie	越南
vin	圣文森特和格林纳丁斯
vir	美属维尔京群岛
vnm	越南
vut	瓦努阿图
wal	威尔士
wkum	威克岛
wlf	瓦利斯和富图纳
wls	威尔士
wsm	萨摩亚
ydye	南也门
yem	也门
yucs	南斯拉夫
zaf	南非
zam	赞比亚
zim	津巴布韦
zmb	赞比亚
zrcd	扎伊尔
zwe	津巴布韦
bhkg	英属香港
bno	英国国民（海外）
chn	中国
chn-1862	中国
chn-1889	中国
chn-1912	中华民国_(大陆时期)
chn-1928	中华民国
chn-1949	中国
chn-hkg	中国（香港）
chn-mac	中国（澳门）
chnml	中国大陆
chn-mld	中国（大陆）
cnhk	中国（香港）
cnmo	中国（澳门）
fjn-roc	中华民国福建省
gbn	英国国民（海外）
hk	香港
hkg	香港
hkg-1514	葡属香港
hkg-1842	英属香港
hkg-1871	英属香港
hkg-1876	英属香港
hkg-1941	日占香港
hkg-1945	英属香港
hkg-1955	英属香港
hkg-1959	英属香港
hkg-chn	中国香港
hkg-gbr	英属香港
hkg-mac	港澳地区
hkg-noc	英属香港
hkg-qing	大清帝国香港地区（大清广东省新安县）
hksar	香港特别行政区
ls	澳葡政府
mac	澳门
mac-1554	葡属澳门
mac-1578	葡属澳门
mac-1616	葡属澳门
mac-1640	葡属澳门
mac-1667	葡属澳门
mac-1707	葡属澳门
mac-1816	葡属澳门
mac-1830	葡属澳门
mac-1911	葡属澳门
mac-1935	葡属澳门
mac-1951	葡属澳门
mac-1967	葡属澳门
mac-1976	葡属澳门
macau	澳门
mac-chn	中国澳门
mac-colonial	葡属澳门
mac-noc	中国澳门
mac-por	葡属澳门
mac-qing	大清帝国澳门地区（大清广东省香山县）
mng-1911	大蒙古国
mng-1919	中华民国
mng-1921	大蒙古国
mng-1924	蒙古人民共和国
mng-1949	蒙古人民共和国
mng-1992	蒙古
msar	澳门特别行政区
pla	中国人民解放军
pla-af	中国人民解放军空军
pla-army	中国人民解放军陆军
pla-navy	中国人民解放军海军
pla-rf	中国人民解放军火箭军
pla-ssf	中国人民解放军战略支援部队
pmac	葡属澳门
pmac-noc	澳葡政府
prc	中华人民共和国
qing-1862	大清
qing-1889=qing	大清
qing-s	清
raem	澳门特别行政区
roc	中华民国
roc-1912	中华民国_(大陆时期)
roc-1921	中华民国
roc-1928	中华民国
roca	中华民国陆军
rocaf	中华民国空军
rocn	中华民国海军
roc-tw	中华民国（台湾）
roc-twn	中华民国（台湾）
taiwan area	中华民国台湾地区
tpe	中华台北
twn	台湾
twn-1895	台湾民主国
twn-afterwar	战后台湾
twn-cqd	大清帝国台湾
twn-esp	西属艾尔摩莎
twn-jpn	日治台湾
twn-qing	清治台湾
twn-roc	中华民国台湾省
twn-voc	荷属福尔摩莎
台湾地区	中华民国台湾地区
中国大陆	中国大陆
中国内地	中国内地
	
eqm	<=>
minus	-
to	→
		
politics
featured article
clear
literature
science
sociology
medical
wiktionary
wikiquote
可视化
技术
天氣
中醫學

\(	\{
\)	\}
\(\(	\{\{
\)\)	\}\}
\!\(	\[
\!\)	\]
!\(\(	\[\[
!\)\)	\]\]

currentyear	2017
currentmonth	03
currentmonthname	3月
currentmonthnamegen	三月
currentmonthabbrev	3月
currentday	24
currentday2	24
currentdow	3
currentdayname	星期五
currenttime	20:40
currenthour	20
currentweek	12
currenttimestamp	20170324204000